23
                  . . . .                     
  + + + + + + + + . . . .                     
  +                   +                       
  +                   +                       
  +                   +                       
  +                   +                       
  +                   +                       
  +                   +                       
  +                   +                       
  +                   +                       
. . .                 +                       
. . .                 +                       
. . .                 +     . .               
. . .                 +     @ .               
. . .                 + + + . M               
. . .                       . .               
. . .                                         
. . .                                         
. . .                                         
                                              
                                              
                                              
                                              

Copyright: created by zhiwenluo on 2017.05.03 AD at 04:12:09

